35 35
1 1 1 1 1 1 1 1 1 1 1 1 1 1 1 1 1 1 1 1 1 1 1 1 1 1 1 1 1 1 1 1 1 1 1 
1 1 1 1 1 1 3 3 3 3 3 3 3 3 3 3 3 3 3 3 3 3 3 3 3 3 1 1 1 1 1 1 1 1 1 
1 1 1 1 1 3 0 0 0 0 0 0 0 0 0 0 0 0 0 0 0 0 0 0 0 0 3 3 1 1 1 1 1 1 1 
1 1 1 1 3 0 0 0 0 0 0 0 0 0 0 0 0 0 0 0 0 0 0 0 0 0 0 0 3 1 1 1 1 1 1 
1 1 1 3 0 0 0 0 0 0 0 0 0 0 0 0 0 0 0 0 0 0 0 0 0 0 0 0 0 3 1 1 1 1 1 
1 1 3 0 0 0 0 0 0 0 0 0 0 0 0 0 0 0 0 0 0 0 0 0 0 0 0 0 0 0 3 1 1 1 1 
1 1 3 0 0 0 0 0 0 3 3 3 3 3 3 3 3 3 3 3 3 3 3 0 0 0 0 0 0 0 0 3 1 1 1 
1 1 3 0 0 0 0 0 3 1 1 1 1 1 1 1 1 1 1 1 1 1 1 3 3 0 0 0 0 0 0 3 1 1 1 
1 1 3 0 0 0 0 3 1 1 1 1 1 1 1 1 1 1 1 1 1 1 1 1 1 3 0 0 0 0 0 0 3 1 1 
1 1 3 0 0 0 0 3 1 1 1 1 1 1 1 1 1 1 1 1 1 1 1 1 1 1 3 0 0 0 0 0 3 1 1 
1 1 3 0 0 0 0 3 1 1 1 1 1 1 1 1 1 1 1 1 1 1 1 1 1 1 3 0 0 0 0 0 3 1 1 
1 1 3 0 0 0 0 3 1 1 1 1 1 1 1 1 1 1 1 1 1 1 1 1 1 1 1 3 0 0 0 0 3 1 1 
1 1 3 0 0 0 0 3 1 1 1 1 1 1 1 1 1 1 1 1 1 1 1 1 1 1 1 3 0 0 0 0 3 1 1 
1 1 3 0 0 0 0 3 1 1 1 1 1 1 1 1 1 1 1 1 1 1 1 1 1 1 1 3 0 0 0 0 3 1 1 
1 1 3 0 0 0 0 0 3 3 3 3 3 3 3 3 3 3 3 1 1 1 1 1 1 1 1 3 0 0 0 0 3 1 1 
1 1 3 0 0 0 0 0 0 0 0 0 0 0 0 0 0 0 0 3 1 1 1 1 1 1 1 3 0 0 0 0 3 1 1 
1 1 3 0 0 0 0 0 0 0 0 0 0 0 0 0 0 0 0 0 3 1 1 1 1 1 1 3 0 0 0 0 3 1 1 
1 1 3 0 0 0 0 0 0 0 0 0 0 0 0 0 0 0 0 0 0 3 1 1 1 1 1 3 0 0 0 0 3 1 1 
1 1 1 3 0 0 0 0 0 0 0 0 0 0 0 0 0 0 0 0 0 3 1 1 1 1 1 3 2 2 2 2 3 1 1 
1 1 1 1 3 3 3 3 3 3 3 3 3 0 3 3 3 0 0 0 0 0 3 1 1 1 1 3 0 0 0 0 3 1 1 
1 1 1 1 1 1 1 1 1 1 1 1 1 0 1 1 1 3 0 0 0 0 3 1 1 1 1 3 0 0 0 0 3 1 1 
1 1 1 1 1 1 1 1 1 1 1 1 1 0 1 1 1 3 0 0 0 0 3 1 1 1 1 3 0 0 0 0 3 1 1 
1 1 1 1 1 1 1 1 1 1 1 1 1 0 1 1 1 3 0 0 0 0 3 1 1 1 1 3 0 0 0 0 3 1 1 
1 1 1 1 1 1 3 3 3 3 3 3 3 0 3 3 3 0 0 0 0 0 3 1 1 1 1 3 0 0 0 0 3 1 1 
1 1 1 1 1 3 0 0 0 0 0 0 0 0 0 0 0 0 0 0 0 3 1 1 1 1 1 3 0 0 0 0 3 1 1 
1 1 1 1 3 0 0 0 0 0 0 0 0 0 0 0 0 0 0 0 0 3 1 1 1 1 1 3 0 0 0 0 3 1 1 
1 1 1 3 0 0 0 0 0 0 0 0 0 0 0 0 0 0 0 0 3 1 1 1 1 1 1 3 0 0 0 0 3 1 1 
1 1 3 0 0 0 0 0 0 0 0 0 0 0 0 0 0 0 0 3 1 1 1 1 1 1 1 3 0 0 0 0 3 1 1 
1 1 3 0 0 0 0 3 3 3 3 3 3 3 3 3 3 3 3 3 3 1 1 1 1 1 1 3 0 0 0 0 3 1 1 
1 1 3 0 0 0 3 3 3 0 0 0 0 3 1 1 3 0 0 0 0 3 3 1 1 3 3 0 0 0 0 0 3 1 1 
1 1 3 0 0 0 3 3 0 0 0 0 0 0 3 3 0 0 0 0 0 0 0 3 3 0 0 0 0 0 0 0 3 1 1 
1 1 3 0 0 0 0 0 0 0 3 3 0 0 0 0 0 0 3 3 0 0 0 0 0 0 0 0 0 0 0 0 3 1 1 
1 1 1 3 0 0 0 0 0 3 1 1 3 0 0 0 0 3 1 1 3 3 0 0 0 0 0 0 0 0 0 3 1 1 1 
1 1 1 1 3 3 3 3 3 1 1 1 1 3 3 3 3 1 1 1 1 1 3 3 3 3 3 3 3 3 3 1 1 1 1 
1 1 1 1 1 1 1 1 1 1 1 1 1 1 1 1 1 1 1 1 1 1 1 1 1 1 1 1 1 1 1 1 1 1 1 
19 32 19 27
