15 20
1 1 1 1 1 1 1 1 1 1 1 1 1 1 1 1 1 1 1 1 
1 3 3 3 3 3 3 3 3 3 3 3 3 3 3 3 3 3 3 1 
1 3 0 0 0 0 0 0 0 2 0 0 0 0 0 0 0 0 3 1 
1 3 0 0 0 0 0 0 0 2 0 0 0 0 0 0 0 0 3 1 
1 3 0 0 0 0 0 0 0 2 0 0 0 0 0 0 0 0 3 1 
1 3 0 0 0 3 3 3 3 3 3 3 3 3 3 0 0 0 3 1 
1 3 0 0 0 3 1 1 1 1 1 1 1 1 3 0 0 0 3 1 
1 3 0 0 0 3 1 1 1 1 1 1 1 1 3 0 0 0 3 1 
1 3 0 0 0 3 1 1 1 1 1 1 1 1 3 0 0 0 3 1 
1 3 0 0 0 3 3 3 3 3 3 3 3 3 3 0 0 0 3 1 
1 3 0 0 0 0 0 0 0 0 0 0 0 0 0 0 0 0 3 1 
1 3 0 0 0 0 0 0 0 0 0 0 0 0 0 0 0 0 3 1 
1 3 0 0 0 0 0 0 0 0 0 0 0 0 0 0 0 0 3 1 
1 3 3 3 3 3 3 3 3 3 3 3 3 3 3 3 3 3 3 1 
1 1 1 1 1 1 1 1 1 1 1 1 1 1 1 1 1 1 1 1 
8 1 8 5